ROBOT_TYPE: FourDirectionHolonomic
DOF: 2
MAP_DIMENSIONS: [32, 21]
ROBOT_COUNT: 19
GOAL_SET
[ 1, 1 ]: [ 30, 1]
[ 1, 2 ]: [ 30, 2]
[ 1, 3 ]: [ 30, 3]
[ 1, 4 ]: [ 30, 4]
[ 1, 5 ]: [ 30, 5]
[ 1, 6 ]: [ 30, 6]
[ 1, 7 ]: [ 30, 7]
[ 1, 8 ]: [ 30, 8]
[ 1, 9 ]: [ 30, 9]
[ 1, 10 ]: [ 30, 10]
[ 1, 11 ]: [ 30, 11]
[ 1, 12 ]: [ 30, 12]
[ 1, 13 ]: [ 30, 13]
[ 1, 14 ]: [ 30, 14]
[ 1, 15 ]: [ 30, 15]
[ 1, 16 ]: [ 30, 16]
[ 1, 17 ]: [ 30, 17]
[ 1, 18 ]: [ 30, 18]
[ 1, 19 ]: [ 30, 19]
MAP
11111111111111111111111111111111
1i0000000000000100000000000000g1
1i0000000000000100000000000000g1
1i0000000000000100000000000000g1
1i0000000000000100000000000000g1
1i0000000000000100000000000000g1
1i0000000000000100000000000000g1
1i0000000000000100000000000000g1
1i0000000000000100000000000000g1
1i0000000000000100000000000000g1
1i0000000000000000000000000000g1
1i0000000000000100000000000000g1
1i0000000000000100000000000000g1
1i0000000000000100000000000000g1
1i0000000000000100000000000000g1
1i0000000000000100000000000000g1
1i0000000000000100000000000000g1
1i0000000000000100000000000000g1
1i0000000000000100000000000000g1
1i0000000000000100000000000000g1
11111111111111111111111111111111
