GOAL_SET
[ 1, 3 ]: [ 5, 3]
[ 3, 1 ]: [ 3, 5]
MAP
1111111
111i111
1110111
1i000g1
1110111
111g111
1111111