ROBOT_TYPE: FourDirectionHolonomic
DOF: 2
MAP_DIMENSIONS: [22, 32]
ROBOT_COUNT: 4
GOAL_SET
[ 6, 12 ]: [ 20, 20]
[ 15, 12 ]: [ 1, 12]
[ 6, 20 ]: [ 20, 12]
[ 15, 20 ]: [ 1, 20]
MAP
xxxxxxxxxxxxxxxxxxxxxxxxxxxxxxxx
x00000000000gx00000xg0000000000x
x000000000000x00000x00000000000x
x000000000000x00000x00000000000x
x000000000000x00000x00000000000x
x000000000000x00000x00000000000x
x00000000000ix00000xi0000000000x
x0xxxxxxxxxxxx00000xxxxxxxxxxx0x
x0xxxxxxxxxxxx00000xxxxxxxxxxx0x
x000000000000000000000000000000x
x00000000000000xxx0000000000000x
x00000000000000xxx0000000000000x
x000000000000000000000000000000x
x0xxxxxxxxxxxx00000xxxxxxxxxxx0x
x0xxxxxxxxxxxx00000xxxxxxxxxxx0x
x00000000000ix00000xi0000000000x
x000000000000x00000x00000000000x
x000000000000x00000x00000000000x
x000000000000x00000x00000000000x
x000000000000x00000x00000000000x
x00000000000gx00000xg0000000000x
xxxxxxxxxxxxxxxxxxxxxxxxxxxxxxxx
FLIPPED