ROBOT_TYPE: FourDirectionHolonomic
DOF: 2
MAP_DIMENSIONS: [22, 32]
ROBOT_COUNT: 4
GOAL_SET:
[ 6, 11 ]: [ 20, 19]
[ 15, 11 ]: [ 1, 11]
[ 6, 19 ]: [ 20, 11]
[ 15, 19 ]: [ 1, 19]
MAP:
xxxxxxxxxxxxxxxxxxxxxxxxxxxxxxx
x0000000000gx00000xg0000000000x
x00000000000x00000x00000000000x
x00000000000x00000x00000000000x
x00000000000x00000x00000000000x
x00000000000x00000x00000000000x
x0000000000ix00000xi0000000000x
x0xxxxxxxxxxx00000xxxxxxxxxxx0x
x0xxxxxxxxxxx00000xxxxxxxxxxx0x
x00000000000000000000000000000x
x0000000000000xxx0000000000000x
x0000000000000xxx0000000000000x
x00000000000000000000000000000x
x0xxxxxxxxxxx00000xxxxxxxxxxx0x
x0xxxxxxxxxxx00000xxxxxxxxxxx0x
x0000000000ix00000xi0000000000x
x00000000000x00000x00000000000x
x00000000000x00000x00000000000x
x00000000000x00000x00000000000x
x00000000000x00000x00000000000x
x0000000000gx00000xg0000000000x
FLIPPED