ROBOT_TYPE: FourDirectionHolonomic
DOF: 2
MAP_DIMENSIONS: [32, 22]
ROBOT_COUNT: 4
GOAL_SET
[ 12, 6 ]: [ 12, 1]
[ 12, 15 ]: [ 12, 20]
[ 20, 6 ]: [ 20, 1]
[ 20, 15 ]: [ 20, 20]
MAP
11111111111111111111111111111111
100000000000g1000001g00000000001
10000000000001000001000000000001
10000000000001000001000000000001
10000000000001000001000000000001
10000000000001000001000000000001
100000000000i1000001i00000000001
10111111111111000001111111111101
10111111111111000001111111111101
10000000000000000000000000000001
10000000000000011100000000000001
10000000000000011100000000000001
10000000000000000000000000000001
10111111111111000001111111111101
10111111111111000001111111111101
100000000000i1000001i00000000001
10000000000001000001000000000001
10000000000001000001000000000001
10000000000001000001000000000001
10000000000001000001000000000001
100000000000g1000001g00000000001
11111111111111111111111111111111
