ROBOT_TYPE: FourDirectionHolonomic
DOF: 2
MAP_DIMENSIONS: [32, 22]
ROBOT_COUNT: 10
GOAL_SET:
[27, 17]:   [24, 16]
[7, 7]:     [29, 1]
[15, 18]:   [23, 16]
[1, 10]:    [18, 13]
[4, 20]:    [28,10]
[13, 11]:   [17, 10]
[1, 4]:     [12, 6]
[6, 6]:     [18, 6]
[16, 9]:    [5, 20]
[12, 15]:   [23, 2]
MAP:
11111111111111111111111111111111
10000001000000000000001010011g01
10001011001111010010000g10000001
10000100001000000001000001000001
1i000010000100000100000100010001
10010101001010000011001001000001
100011i10000g00001g0000000011101
1000000i000000000000000001000001
10000000000000000000000000101001
1000000000000000i001100100000101
1i001000000001000g0101010100g001
1001001000000i000100000010000001
11001100000010000010010000001001
101000000001100000g0000100000001
10001000000000001000001000000001
100000000010i0000000110000010101
10000000000000010010000gg0000001
101000000000100000001010110i0101
101000100100001i0000100000000101
10010010010000000001000100000011
1000ig00000000000000011000100001
11111111111111111111111111111111