ROBOT_TYPE: FourDirectionHolonomic
DOF: 2
MAP_DIMENSIONS: [22, 32]
ROBOT_COUNT: 10
GOAL_SET:
[17, 27]:   [16, 24]
[7, 7]:     [1, 29]
[18, 15]:   [16, 23]
[10, 1]:    [13, 18]
[20, 4]:    [10, 28]
[11, 13]:   [10, 17]
[4, 1]:     [6, 12]
[6, 6]:     [6, 18]
[9, 16]:    [20, 5]
[15, 12]:   [2, 23]
MAP:
xxxxxxxxxxxxxxxxxxxxxxxxxxxxxxxx
x000000x00000000000000x0x00xxg0x
x000x0xx00xxxx0x00x0000gx000000x
x0000x0000x00000000x00000x00000x
xi0000x0000x00000x00000x000x000x
x00x0x0x00x0x00000xx00x00x00000x
x000xxix0000g0000xg00000000xxx0x
x000000i00000000000000000x00000x
x0000000000000000000000000x0x00x
x000000000000000i00xx00x00000x0x
xi00x00000000x000g0x0x0x0x00g00x
x00x00x000000i000x000000x000000x
xx00xx000000x00000x00x000000x00x
x0x00000000xx00000g0000x0000000x
x000x00000000000x00000x00000000x
x000000000x0i0000000xx00000x0x0x
x00000000000000x00x0000gg000000x
x0x000000000x0000000x0x0xx0i0x0x
x0x000x00x0000xi0000x00000000x0x
x00x00x00x000000000x000x000000xx
x000ig000000000000000xx000x0000x
xxxxxxxxxxxxxxxxxxxxxxxxxxxxxxxx
FLIPPED